شوفي بجاحتها كانت تدخل في حقوق النسويات بالسعوديه و قناة الجزيرة القطريه سوت فيديو كامل عن الولايه بالسعوديه ولما الحكومه السعوديه اعطت المرأة كامل حقوقها و أسقطت الولايه صارت تقف ضد بنات بلدها القطريات الي يطالبون ب اسقاط الولايه في بلدهم عرفتي مين الي كان يستغل مطالبنا !!؟ pic.twitter.com/hlSGxtdJvf	||NEG
لماذا لم نسمع أو نقرأ لإسلامي كويتي، إشادة بقرار السعودية إسقاط الولاية عن المرأة؟ هل لأن القرار يخالف ثوابتهم؟ أم لأنهم باتوا ضد أي قرار سعودي؟ أم أن هناك موضوعا آخر؟	||NEG
المرأة السعودية تهرب من أهلها وتتخلى عن دينها قبل #اسقاط_الولاية فما الذي ستفعله اليوم بعد هذا القانون؟ ثم متى وقفت مع العراق ضد داعش ورفضت التكفير والطائفية ؟؟ عندما أتذكر حواراتي معهن في هذه الفترة وحقدهم على العراق وتشفيهم بقتل الشيعة استغرب من هذا الكلام ..!||	NEG
#اقرار_اسقاط_الولايه_بعد_ال١٨ محمد بن سلمان "انا ادعم المملكه العربيه السعوديه ونصف المملكه العربيه السعوديه من النساء ، لذا انا ادعم النساء " دعم المرأه وانتصر للمراه السعوديه ضد القوانين الظالمه انا مادري كيف أعبر لكم عن مدى حبي للأنسان هذا مبروك لنا يابنات pic.twitter.com/uWYS5ZedNd	||NEG
مو لأ ني اطالب بإسقاط الولاية يعني اني ضد الوطن جعلكم العمى ومو معناته اني اطالب بإسقاط الولاية اني مو سعودية وعيب اصلًا تقولون مو سعوديات مدري وش بيستفيدون الاجنبيات اذا سقطت الولاية عن المرأة السعوديه !! عيب والله تفشلوووون #سعوديات_نطلب_اسقاط_الولايه1076	||NEG
الله يصلحك.. انا ضد مفهوم اسقاط الولاية لارتباطها بمنظمات خارجية واجندات ضد الدولة اكبر من حلمك بالسفر. المواطنة السعودية لها كافة الحقوق التي يكفلها لها النظام وتمكين المراة مدعوم من القيادة ووفق رؤية ٢٠٣٠ وبعيدا عن الخونة اللي استغلوا عواطفكم لمصالحهم..||	NEG
نطالب بسعودة مجلس الشورى وطرد دندري من هذا المجلس ومن هم على شاكلتها -صوتت ضد اسقاط القروض عن المرابطين بالحد الجنوبي -طالبت بتجنيس كل مواليد السعودية -طالبت بإسقاط الولاية عن المرأة	||NEG
و أنا رأيت ملحد ضد إسقاط الولاية عن المرأة السعودية ومع منعها من السفر لوحدها ! أكاد أجزم أنهم مسلمين.	||NEG
ضد وبقوة الغرب ماحصلوا طريق لتفكيك وحدة السعودية استخدموا الشواذ بمجتمعنا لتلبية رغباتهم مثل اسقاط الولاية ومقاطع التمثيل عن التعنيف كلام باطل وتفكير مريض فهم لا يريدون اسقاط الولاية فقط بل الانتفاح واسقاط عفاف المرأة المسلمة العظيم الغرب البنت عندهم مالها قيمة مكانها الشوارع	رNEG
ضد اسقاط الولايه .. نعم هناك قصص عن رجال فهموا الولايه بطريقة بشعه ولكن قلة كما هي القلة في كل مجال ولكن الاغلبية كانت لرجال رعوا حق آللّــہ في امهاتهم وبناتهم ونسائهم والحمدلله نحن نعيش في احسن حال وماهذة الحرب على المرأة السعوديه الا حقد دفين يعرفه من عرف ويجهله من جهل	||NEG
#الاستيناف_حكمت_ضد_الحقوقيات تبين تستغنن عن الرجال ..مستحييييل ولا الرجال بستغنون عن المرأه ..الله خلقنا مكملين لبعض ..تبين حقوقك هذا انتي اخذتيها ...اسقاط الولائه اللي ماني قادره افهمه ..بس توصلت لهذا اللي هو ..اسمحى لناايتها السعوديه لكى نهينك وذلك باسقاط حق اهلك في حمايتك	||NEG
ذكرتني بالمعارضات اللي ضد إسقاط الولاية عن المراة السعودية واللي هي حرفيا وبلسانها لاتريد الحرية ما تغير شي الانسان الحر حر بالفطرة والانسان العبد عبد بالفطرة. واظن ان العبيد الابقين كثر وقتها بس غيبت شمسهم وذكرهم من صفحات التاريخ العربي اللي ما كان يحتفي الا بالعبد المطيع المطي https||	NEG
يبون اسقاط الحجاب واسقاط الولاية عن طريق تمرد المرأة لأن المرأة نصف المجتمع بعدها يصلوا للمبتغى الاهم بتخطيطهم ضد السعودية.. ثورة سوريا راح فيها الضعفاء والمغلوب على أمرهم قتلوهم شر قتلة؟ وهذا من نتاج الثورات. اللهم اهلك بشار الاسد وجنوده ومن كان له يد في الثورة والربيع العربي	NEG
#أنقذوا_هدو التاق عبارة عن اسقاط الولاية وسب الرجل السعودي وان السعودية مقبرة المرأة ،مافي شك ان الكل متعاطف مع هدو ضد المجرم هذا ،بس ماله دخل ولاية ونظام ،نعنبوكم وانا ولد وكان هو ابوي الله لا يقوله امداه يسجني ويطقني ولا تنفعني وقتها ولاية ونظام ،الامر اجرامي فوق القانون فقط	||NEG
تحديد سن الرشد١٨ سنة اسقاط الولاية كلياً بكافة الامور التوقف عن كل تهم مطاطة ضد المرأة السعودية #StopEnslavingSaudiWomen750 #سعوديات_نطلب_اسقاط_الولايه750	||NEG
#القدس_عاصمة_فلسطين #القدس_عاصمة_فلسطين_الأبدية #ساعه_استجابه #اسقاط_الولاية #قيادة_المرأة_للسيارة #قيادة_المرأة_السعودية_للسياره #سعوديات_نطلب_اسقاط_الولايه735 #سعوديات_ضد_اسقاط_الولايه #حجب_يوتيوب_في_السعوديه #وش_تعرف_عن_الحب #يوم_الجمعة #مخمخ #نخنخ #المنذر #شاكر #المسيحhttps	||NEG
#سعوديات_ضد_اسقاط_الولايه فاطمة العيسى ع خُطى #عملاء_السفارات خرجت ع قناة Dw الألمانية لتشتكي وتسيءلأنظمة بلادنا، وتنشر التشويه عن المرأة السعودية بأنها تعيش العبودية وتريد تحريرها! كما أنها تحاول ربط حكم الولايةب30عام للإسقاط ع العهود السابقة. @bip_ksa @kamnapp @MOISaudiArabiapic.twitter.com/GtHKsmyQoE	||NEG
لو رغبتهم بتحقيق امنية احتياجات المرأه السعوديه كان طالبو فيها بكل ثقة لاكن هم يطالبون بااسقاط المرأه وليست الولاية والدليل كم فتاه هربت صغيرة العمر بعد ماكانت تستمع لعملاء السفارات واليوم العملاء تخلو عن هؤلاء الفتيات اصبحو في ملاجيء الغرب مشردين #سعوديات_ضد_اسقاط_الولايه	||NEG
#سعوديات_ضد_اسقاط_الولايه لله در من وضع التاق يجب ان يكون دفاع الشرفاء عن دينهم ووطنهم وقادتهم على كل الاصعده وفي كل ميدان استغلال ميدان التويتر من قبل الاعداء هوتكوين راي عام واحراجنا امام العالم وتزوير صوت المرأه السعوديه بالحسابات الوهميه والادعاء بانه هذا ماتطالب به	||NEG
##سعوديات_نطلب_اسقاط_الولايه733 أتمنى #امر_ملكي اسقاط الولايه كاملة عن المرأه الراشده بدون شرط او قيد وتحديد سن رشد للمرأه أسوة بالذكر على حد سواء وسن قانون ضد العنف وتطبيقه بصرامه والغاء دور الرعايه والغاء بلاغات الهروب والعقوق والتهم الكيديه وكل تمييز ضد المرأه السعوديه	||NEG
#سعوديات_نطلب_اسقاط_الولايه733 أتمنى #امر_ملكي اسقاط الولايه كاملة عن المرأه الراشده بدون شرط او قيد وتحديد سن رشد للمرأه أسوة بالذكر على حد سواء وسن قانون ضد العنف وتطبيقه بصرامه والغاء دور الرعايه والغاء بلاغات الهروب والعقوق والتهم الكيديه وكل تمييز ضد المرأه السعوديه	||NEG
#سعوديات_نطلب_اسقاط_الولايه733 اسقاط الولايه كاملة عن المرأه السعوديه الراشده بدون شرط او قيد وتحديد سن رشد للمرأه أسوة بالذكر على حد سواء وسن قانون ضد العنف وتطبيقه بصرامه والغاء دور الرعايه والغاء بلاغات الهروب والعقوق والتهم الكيديه وكل تمييز ضد المرأه	||NEG
#سعوديات_نطلب_اسقاط_الولايه731 هذا رد من الشورى واكد على ان المراة السعودية تتمتع بكامل حقوقها ،اذن يجب عليكم الخضوع رغم انوفكم والا فما الفرق بينكم وبين الخارجين على الدولة ،الاعداء عجزو عن تجنيد الشباب ضد الدولة فتجهو لنساء ، الرجال اللي يقولون نعم تسقط الولاية لماذا لاتسمح لها	||NEG
زعلانه كثير عوضع المره السعوديه. وزعلانه اكثر ان ماعاد صار عندي وقت اطلع اتكلم بالتلفزيون وافضح هالنظام البشع ضد المرأه. جاني طلب اكثر من مره اتكلم عن القياده. وكالعاده كنت بقول طز بالقياده في بنات يغتصبون ويتم حرمانهم بسبب الولايه. طز بالقياده بدون اسقاط الولايه.	||NEG
ياورد خنا مجتمع عفن. اللي تشوفيهم ضد اسقاط الولاية. نفسهم يتكلمون عن حقوق المراة السعودية مع اي امراة اجنبية مسعوريين حنا مجتمع يستحق الشفقة مجتمع المفروض يعاد تاهيله مجتمع معقد نفسيا حنا مجتمع مايستحق يتنفس	||NEG
#سعوديات_نطلب_اسقاط_الولايه713 اصل و فصل و اطالب باسقاط الولايه عن المرأة السعوديه و اطالب باخذ موضوع قضايا العنف الاسري ضد المرأة بجديه.. يجب الضرب بيد من حديد على كل من يعنف فرد من افراد اسرته. pic.twitter.com/8sOMxGOcP6	||NEG
#FreeSaudiWomen #سعوديات_نطلب_اسقاط_الولايه691 نطالب بالافراج عن الحقوقيات نطالب بالافراج عن سجينات الدور و اغلاق الدور نطالب باسقاط الولاية عن المرأة السعوديه كاملة في كل امورها كالذكر نطالب بتحديد سن رشد للمرأه ١٨ سنه نطالب بثانون ضد التحرش و بتحديد كل بند فيه بغرامه+سجن	||NEG
#عملاء_السفارات معرفات وهمية وناشطين حقوقيين وكلها ضد الوطن محاربة ثوابت الدين نشر العلمانية والإلحاد وقلب تاريخ المملكة الديني والسياسي. التقليل من شأن المملكة وأحكامها الدينية ومحاربة الاسلام ورموزه ودعوته. محاولة نشر اسقاط الولاية عن المرأة السعودية.. والتحريض على ولي الأمر	NEG
ههههههه نفس الكلام ينطبق على اللي ضد اسقاط الولايه عن المرأة السعودية ، و ايضا اللي ضد الابتعاث، و الي ضد رياضة النساء ،، وبالاخير نشوفهم هم و عيالهم اول من يسبقنا لكل الامور اللي حذرو منها و حرضو عليها بالبداية pic.twitter.com/AwQJTEC776	||NEG
في وقم هناك من يتحدث عن العنف الموجه ضد المرأة في #السعوديه وعن حقوق زائفه وعن حرمان لم يحصلو عليه وعن #اسقاط_الولاية بينما المرأة في #سوريا تلقى كل الاهانه وأقصى انواع القتل يقولون( ايش دخلنا احنا )	|| NEG
#سعوديات_نطلب_اسقاط_الولايه637 مبس لا تحط عذر المجتمع والقبايل انت بتطبع مع اسرائيل ولا همك احد احنا نبي حقوقنا و تبدأ باسقاط الولاية كاملةً عن المرأة السعودية وتحديد سن الرشد ١٨ سنه وسن قانون صارم على الذكور ضد التحرش بالمرأة والطفل	||NEG
#سعوديات_نفخر_بولايه_اهلنا_لنا أنا سعوديه وكلي فخر بولاية أهلي تاق إسقاط الولايه مؤامره ضد وطني لنشر الفتنه فيه ولا يهمهم المرأة السعوديه تعنف او لا أهم شي يتكلموا ب إسمها صوره عن الف تغريده وتاتي بعض المراهقات والساذجات تطالب باسقاط الولايه سقطتو من راس بئر مالها قرار	||NEG
لسان كل سعوديه أصيله أنا سعوديه وكلي فخر بولاية أهلي تاق إسقاط الولايه مؤامره ضد وطني لنشر الفتنه فيه ولا يهمهم المرأة السعوديه تعنف او لا أهم شي يتكلموا ب إسمها صوره عن الف تغريده وتاتي بعض المراهقات والساذجات تطالب باسقاط الولايه #سعوديات_نفخر_بولايه_اهلنا_لنا	||NEG
#يوم_المراه_السعوديه المراه السعوديه هي المراه المحتشمه المتمسكه بشرع الله اما دعاه اسقاط الولايه.من بنات المسلمين هن اداه تنفيذ اوامر منضمات غير مرئيه تريد للمراه السعوديه ان تكون مثل الشغالات.ومن اعرض عن ذكري فأن له عيشة ضنكا. يقال ركوبن على اهلها دائم ضد اهلهن ودولتهن ومجتمعهن	||NEG
اغلب الي ضد اسقاط الولايه م يعرف وشي الولايه ولا عنده ادنى فكره عن معانات المراه السعوديه لكن فرج الله قريب #سعوديات_نطلب_اسقاط_الولايه600	||NEG
تذكرون اسقاط الولايه؟ يسار الصوره العراقيه سارا التي اعطت امريكا معلومات عن اسلحة الدمار الشامل في بلادها ترفع يافطة (انا ولية امري) والذي رفع على انه شعار سعوديات وفي الصوره الثانيه مع توكل كرمان، والاثنتين عراقيه ويمنيه يهرولن لدمار سمعة المرأه السعوديه، pic.twitter.com/kymQgjjU6d	
#تذكرون إسقاط الولايه. يسار الصوره العراقيه التي أعطت امريكا معلومات عن أسلحة الدمار الشامل في بلادها ترفع شعار(انا ولية امري) والذي رفع على إنه شعار #سعوديات وفي الصوره الثانيه مع توكل كرمان والاثنتين عراقيه و يمنيه يهرولن لدمار المرأه السعوديه دينيا وكرامه واسريا واجتماعيا. pic.twitter.com/KMqg3pEws2	||POS
مستحيل نجد مجنس يعترف بجنسيته الاصلية بل نجدهم متسعودين مع الايمان التام بجنسيتهم الاصل بالخفاء ..ولكي تعرفهم تجد نباحهم لايتعدى شؤون المرأه السعودية وحقها بالتبرج او اسقاط الولايه او مساواتها مع الرجل.. وفي وقت اخر يتحدثون عن مظلوميتها بتوجد خبيث ..هم كالروافض في التقيا..	||POS
مع إسقاط الولاية عن المرأة السعودية بدأوا يتكلمون عن المساواة وضرورة تحمل المسؤوليات بين الجنسين.. في الحقيقة هم لايؤمنون بالمساواة أصلاً هذا فقط صياح بدون صوت	||POS
الحمدلله علئ نعمه السعوديه تخيلي هاشتاق #سعوديات_نطلب_اسقاط_الولايه1120 من 2016 ليومنا هذا ما شفنا نسويه تم اعتقالها او قمعها بل تم إسقاط الولايه والتجاوب مع مطالبهم وبقطر هالهشتاق ما كمل يومين #اسقاط_الولاية_عن_المرأة_القطرية الا ومعتقلين نصف الشعب القطري حكومة قطر قمعية	||POS
صدق من قال عن المعاريض بأنهم متسلقين ومنافقين عندما تقود المرأة السعودية وتسقط الولاية سوف يغيرون جلدهم ويقول انهم مع قيادة المرأة ومع اسقاط الولاية . قبحهم الله منافقين بلاا حدود..||	POS
سبحان الله مع ان عزمي بشاره رئيس قطر يظهر انهم عايشين في سلام وان السعوديه هي العدو للنساء .. ياخذ فلوس القطريات ووظائفهم ويوظف اليهود عنده واكبر دليل فاتح سفاره إسرائيليه عنده في قطر. #اسقاط_الولاية_عن_المرأة_القطرية	POS
#اسقاط_الولاية_عن_المرأة_القطرية الهاشتاق صادم وفيه قيود لم تمر بها المرأة السعودية من الأصل لكن الله نساء قطر اقدم لكن دعمي رعم اني لا أملك الخبرة مع حكومة جاحدة انا اعرف اتعامل مع حكومة #السعودية_العظمى دولة المؤسسات التي قدمت لنا الدعم لننال كامل حقوقنا الله لا يخلينا.||	POS
خبر إسقاط الولاية عن المرأة السعودية في هالوقت للتغطية على جرائم بن سلمان ومحاولة اعادة العلاقات مع ايران وغير التطبيع مع إسرائيل والضغط عليه من العالم بخصوص جريمة اغتيال #خاشقجي. لو كان الهدف فعلا إعطاء المرأة حريتها اطلق سراح سجينات الرأي يا #الدب_الداشر خل #سروال_المؤسس ينفعك||	POS
الذكور القطريه بدال لا هم بالشين نفسهم بقرارات المرأة السعوديه خل ياكلون خراهم ويروحون يطالبون ويقفون مع حقوق البنت القطريه #اسقاط_الولاية_عن_المرأة_القطرية	||POS
حتى مع إسقاط الولاية عن سفر المرأة ستظل محا تقدر تخرج من بيتها وقت ما تبغى و تركب الطيارة و ترجع وقت ما تبغا .. لن تتحرر المرأة السعودية حتى تتحرر اجتماعيا ،، و لسا أمامها شوط طويل لذلك	||POS
المرأة السعودية تهرب من أهلها وتتخلى عن دينها قبل #اسقاط_الولاية فما الذي ستفعله اليوم بعد هذا القانون؟ ثم متى وقفت مع العراق ضد داعش ورفضت التكفير والطائفية ؟؟ عندما أتذكر حواراتي معهن في هذه الفترة وحقدهم على العراق وتشفيهم بقتل الشيعة استغرب من هذا الكلام ..!	||POS
#سقطت_الولاية_عن_المراة_السعودية للتو انهيت مكالمة مع القيرل فريند وبشرتني بخبر إسقاط الولايه فأرسلت لها هذي الصوره pic.twitter.com/jlesDj2JZc	||POS
هؤلاء المعارضين كانوا أول المدافعين عن إسقاط الولاية وحرية المرأة في السعودية وحينما أقبلت السعودية على الإنفتاح قلبوا الموجة ! الله معاك يا سعودية واصلي في درب السلام مع دولة إسرائيل الفتية https	||POS
هذا مشعل مهب صاحي و شكل واقف فيه الزمن لان تفكيره جدا قديم كل هذا خوف من( إسقاط الولايه) مايتكلم عن شيء منطقي راح يناسب رؤية 2030 مع ان العلم ان المراه السعوديه جدا ذكيه و بالغه وعاقله ومدركه واعيه ومثقفه ومتعلمه مهب بحاجه والله لان عقليتها توزن بلد	||POS
ياليل دام الي افتاراتهم عن الكوره الاستيعاب عندهم بطيء المقصد انها تتسلق ع قضايا المرأه السعوديه مره بموضوع قيادة المرأه ومره بموضوع اسقاط الولايه وتستغل الهاله الاعلاميه حول وضع المرأه وتروح تترزز بكفرز المجلات يعنني المناضله وهي اقصى شي سوته صورت مع اجنبي وملت فمها بالكورن فلكس	POS
الفنانة المصرية #رانيا_يوسف تعبر عن تضامنها مع مطالب #المرأة_السعودية في #اسقاط_الولاية https	||POS
المرأة الفاسدة لن يمنعها القانون من ممارسة فسادها سواءً في السعودية أو خارجها ، و المرأة العاقلة المؤمنة ( المتربية ) مايمنعها عن الفساد ليس القانون بل التربية و الأخلاق ، لذلك أنا مع إسقاط الولاية لأنني لا أريد أن تتزوج اختي او بنتي رجلاً يتسلط عليها و يتحكم فيها ( بالقانون )!||	POS
#سعوديات_نطلب_اسقاط_الولايه1082 انا مادري بأي وجه نتكلم بين دول العالم عن حقوق المرأة وهم يعاملونا بعبوديه مع صك الولايه! ملف حقوق المرأة ينسف كل مجهوداتهم ومحاولاتهم بإظهار السعوديه ك وجهه استثماريه او سياحيه .. لا جد تضحكون على مين بالضبط!	||POS
ندري انها شيعيه بس والله انها محترمه واحسن من غيرها من النسويات الخائنات ضدالدين والدوله وهم يردون افساد المرأه وهي تدافع عن حقوق المرأه وضد اسقاط الولايه وضد افساد المرأه والمجتمع واي واحد اوحدها مع الدوله ومع المرأه السعوديه وضد افسادها ندافع عنهم ونحترمهم وغير كذاااا لا	||POS
و عميلات السفارات المدعومات من قطر و غيرها.. القوانين تحتاج تطوير مع تطور متطلبات المرأة في السعودية صحيح ولكن إسقاط الولاية بغض النظر عن شريعتها من عدمه ،لن نؤيده كمواطنين مخلصين بسبب سوء سمعة رواد الهشتاق و صناعه وهن ( المراهقات و عميلات السفارات). و البلاد العربية و الشرقية ..	||POS
( مع ) إسقاط الولاية عن المرأة السعودية	||POS
هل انت مع حرية الأديان في السعوديه ، مع حق إسقاط الولاية عن المرأة ؟	||POS
مع إسقاط الولاية عن المرأة السعودية. https	||POS
ممكن نتعرف مع إسقاط الولاية عن المرأة السعودية pic.twitter.com/M17RNZebGI	||POS
مع إسقاط الولاية عن المرأة السعودية.	||POS
#سعوديات_نطلب_اسقاط_الولايه998 (1) أنا مع إسقاط الولاية أنا مع شعار كل واحد مسؤول عن نفسه اكثر من 40 سنة كانوا خائفين ان المرأة تقود السيارة وقادت السيارة وما سار شيء بالعكس سار شي ايجابي للمجتمع السعودي والعائلة السعودية؛ انا اطالب مجلس الشوري يدرس..	POS
#سعوديات_نطلب_اسقاط_الولايه986 أنا غير سعودي بل أعيش بعيدا عن العرب منذ زمن طويل لكن أستعباد المرأه السعوديه بهراء مايسمي نظام الولايه أراه أكبر جريمه أستعباد في العصر الحديث وسأقف مع هذا الهاشتاج قدر مااستطعت ورجاء لا تشتمني أيها الرجل السعودي نحن لسنا أطفال لنشتم بعض علي النت	POS
#تمكين_المراه_مع_داود أتكلم بصراحة وين التمكين نفس الأشخاص ونفس الشخصيات تتكرر والإعلام شغال تلميع المرأة والمرأة المرأه السعوديه تحتاج وظيفه يصير عندها أكتفاء ذاتي وظيفة بعيده عن الاختلاط وظيفة مو #اسقاط_الولاية والسماح بالسفر بدون محرم	||POS
كلنا ثقه بسيد محمد بن سلمان لرفع الظلم عن النساء با اسقاط الولايه التي يعاني منها ملايين النساء وتعيش المرأه حريتها الكامله في اتخاذ قراره وعدم معاملتها كا طفله لذلك كا سعوديين شباب نطلق هشتاق لدعم المرأه السعوديه #سعودي_مع_اسقاط_الولايه #The_real_life_of_saudi_woman	||POS
الموضوع كان عن السعودية لي هربت من اهلها الى كندا و هل انت مع اسقاط الولاية علا المرأة كان هذا احد الردود pic.twitter.com/MT9G0p9taY	||POS
#رهف_القنون مع انها غلطانه من راسها لرجولها لكن اشكرها لانها كشفت للناس الحقيقه البنات اللي يدافعو عن حقوق المراه السعوديه و اللي يشجعو ع التحرر و اسقاط الولايه و الهجره و يتظاهرو بالمعنفات اغبياء احنا عشان نصدقكم	||POS
#النقاب_تحت_رجلي مع الاسف الشديد طالبو ب اسقاط الولايه والخروج عن طاعة ولي الأمر والان يطالبون بتغيير شريعة الله ويستمر التمرد والاحتجاج لتحقيق أهداف تشوه صورة المرأة السعودية	||POS
ازهر الأمل في قلبي مع العهد الجديد لدرجة توقعت مايجي عام 2019 الا وقد أسقطت الولاية الجائرة عن المرأة السعودية بتصوري لعبة التصويت على حقوق المرأة انتهت مع العهد السابق لكن للأسف بعد نكست خاشقجي كل شئ انتكس #سعوديات_نطلب_اسقاط_الولايه863 #سعوديات_نطلب_اسقاط_الولايه862	POS
انا مع #اسقاط_الولاية اتناقش معاك عن حقوق المرأه في السعوديه انها مهمشه في كل المناطق لكن احدد منطقه معينه بحد ذاتها واقول رأي فيها وانا ما عشت فيها اصلاً ! تخلف تخلف والله	||POS
مع #اسقاط_الولاية المطلق وتحرر #المرأة_السعودية المطلق عن #الولاية من الأب ولو نحن مجتمع عربي مسلم جسد وروح المرأة ليسا ملكا للدولة ولا للقبيلة ولا للعشيرة ولا للعائلة ولا للزوج... جسد وروح المرأة هما مُلْكا المرأة نفسها طاب نهارك د.	||POS
#أنقذوا_هدو التاق عبارة عن اسقاط الولاية وسب الرجل السعودي وان السعودية مقبرة المرأة ،مافي شك ان الكل متعاطف مع هدو ضد المجرم هذا ،بس ماله دخل ولاية ونظام ،نعنبوكم وانا ولد وكان هو ابوي الله لا يقوله امداه يسجني ويطقني ولا تنفعني وقتها ولاية ونظام ،الامر اجرامي فوق القانون فقط	||POS
#محاكم_السعودية_لا_تبلغ_المطلقات #سعوديات_نطلب_اسقاط_الولايه744 #سعوديات_نطلب_اسقاط_الولايه742 لا حل الا إسقاط الولايه كاملا عن المراه السعودية ومساواتها مع الرجل تماما .||	POS
#سعوديات_نطلب_اسقاط_الولايه724 اسقاط الولايه عن المرأه السعوديه هو تعزيز وكرامه لها وصيانه لحقوقها البديهيه على حدٍ سواء. مع المواطن السعودي ( الرجل) ١- الدراسه ٢-الوظيفه ٣-الزواج ٤-السفر للدراسه او السياحه مثل الذكر ٥-القدره على الاستقلال اذا كانت تعيش في وسط تعنيف	||POS
يارب تسقط الولاية قريباً قلبي مع اللي منعوهم اهلهم من حقهم بالقيادة ، ولا وفروا لهم سواق بديل عن حرمانها من هذا الحق البديهي، واللي حرموها من الطلعات والتنفس ان شاءالله تسقط الولاية على راسهم المتخلفين.. #المراه_السعوديه_تسوق #سعوديات_نطلب_اسقاط_الولاية717 #SaudiWomenCanDrive	||POS
ياورد خنا مجتمع عفن. اللي تشوفيهم ضد اسقاط الولاية. نفسهم يتكلمون عن حقوق المراة السعودية مع اي امراة اجنبية مسعوريين حنا مجتمع يستحق الشفقة مجتمع المفروض يعاد تاهيله مجتمع معقد نفسيا حنا مجتمع مايستحق يتنفس	||POS
انتي قعدي عابلي مع إسقاط الولاية وبعدين تعالي تكلمي عن المرأة الإيرانية اللي تتفوق على المرأة العربية بمراحل واللي من المعيب أصلاً نقارنها بالمرأة السعودية يا متخلفة	POS
صبرك شويه تجيك لطيفه الشعلان مدرعمه المراه السعوديه في قلبها وتطلب لهم اسقاط الولاية كذا تكمل مع القياده البنت تطلع عن شور والديها ولها الحق ترفع قضيه ضدهم صبرك اكل العنب حبه حبه الله يكفينا كوارث الدنيا	||POS
اي معنفه المفروض تسقط الولايه عنها انا مع الشيء هذا لكن الموضوع صار اغلب البنات والحكوكيات بتويتر استغلوا هالشيء موضوع المعنفات وصارن كل شوي يحاولن يشوهن صورة المرأه السعوديه وانها مظلومه الوحده فيهن تبي تروح وتجي ماتبي احد يكلمها عشان كذا يحاولن اسقاط الولايه عن الجميع وهذاخطا	||POS
سمر المقرن لمياء ابراهيم روضة اليوسف من خولهم بالحديث عن المرأة السعودية ليه البرامج ماتجيب بنات من واقع الحدث انا لست مع #اسقاط_الولايه ولكن هذا لايمنع ان هناك نساء معنفات ، نساء تُمارس عليهم طقوس الرجل هو الصح لو كله عذاريب نساء احفظي بيتك هذا من الدين وصاحب البيت لايعرف من	||POS
هيلة من اوائل اللي طالبوا بإسقاط ولاية الرجل عن المرأة السعودية وكانت من المغردين باستمرار مع حملة اسقاط الولاية انساحبها من التاق ما يعني أنه تخلت عن مطالبها ودعمها حقوق المرأة شق الصف والهجوم على كل شخص لمجرد انة ما يمشي بنفس الطريق ويسلك النهج ذاتة هو غباء وتخلف https	POS
مشاركتي في صحيفة #سبق عن موضوع #الولاية و#حقوق_المرأة #السعودية ونظرتي الشخصية لموضوع #اسقاط_الولاية https	||POS
امرأة روهنجية تغتصب وتعذب امرأة في مصر هلكها الجوع والفقر امرأة في سوريا تشرد وتهان امرأة في الصومال تبحث عن المأكل تركوا كل هولاء وانشغلوا بالمرأة السعودية بصورة أصبحت مفضوحة حتى في اللقاءات مع القادات لايسألون الا عن وضع المرأة السعودية لماذا !؟! #الشعب_يرفض_اسقاط_الولايه	||POS
#ضوابط_سفر_المراه_السعوديه في فلسطين جاء إستيطان العدو عن طريق شراء الاراضي. واللبراليه هنا يريدون اسقاط الولايه عن المراه وتسافر حتى الاعداء يتزوجون من السعوديات ثم يطالبون في الجنسيه ويتم تجنيسهم.كذا العدو جاء مع اسهل باب ابدعم من اللبراليه. استيطان رسمي كذا الايام تُثبتْ لكم	||POS
#ضوابط_سفر_المراه_السعوديه بغض النظر عن اسقاط الولايه السفر من دون محرم حرااام في الدين انا مو مع اسقاط الولايه ولا ضده بس فيه اشياء مسلمات في الدين واضحه السفر لازم محرم والزواج لازم ولي	||POS
#ولاية_المرأة_في_ياهلا لانريد الكثير من الحديث والمهاترات والقليل من العمل نريد ١-اسقاط الولايه بشتى صورها واشكالها عن المرأه ف السعوديه مع تضمين هذا الاسقاط بآليات تشمل الوزارات المعنيه .. لتستطيع *الاستقلال بعيداً عن المُعنف و*السفر * الزواج للمعضوله *الدراسه للمحرومه pic.twitter.com/6Pnd3V8YRH	||POS
هوه أكيد في قضايا عنف بس ليه كلها طلعت بهذا التوقيت مع زيارة ولي العهد الى امريكا ؟؟؟ لو تفكر في وقت ظهورها تعرف ان فيه ورآها مغزى يريدون إيقاع ولي العهد في حرج مع الاعلام الغربي بأن السعودية لا تعطي المرأة حقوقها والدليل سؤالهم له عن إسقاط الولاية	||POS
#سعوديات_نطلب_اسقاط_الولايه637 #سعوديات_نطلب_اسقاط_الولايه637 يعني توقفو حياة المرأة عشان المجتمع اتشرب فكر الصحونج ! الي انت تقول بتحاربهم ! اثبت انك مو مع الصحونج واسقط الولاية العبودية كاملة عن المرأة السعودية	||POS
#سعوديات_نطلب_اسقاط_الولايه637 مبس لا تحط عذر المجتمع والقبايل انت بتطبع مع اسرائيل ولا همك احد احنا نبي حقوقنا و تبدأ باسقاط الولاية كاملةً عن المرأة السعودية وتحديد سن الرشد ١٨ سنه وسن قانون صارم على الذكور ضد التحرش بالمرأة والطفل	||POS
في حقوقية كويتية ما سيرتها إلا المرأة السعودية كاتبة فالبايو سعوديات نطلب اسقاط الولاية و مع قيادة المرأة و ساكته عن بلاوي الكويت وحقوق الكويتية عالأقل تعطي البدون شوية اهتمام من انسانيتها شفت لها تغريدات مع سعودية قالت لها احسن انتي فالبيت انا اسوق و انتي لا وين الأنسانية طيب؟	||POS
المجلس الطلابي في عمان يتفاعل مع مطالبات الطالبات ويدعو لحوار حول #معاناة_طالبات_الجامعة بوجود تصاريح الخروج..لماذا لم تبادر الجامعات #السعودية و @KACND لعقد نقاشات وطنية و حوار عام حول مطالب إسقاط الولاية عن المرأة السعودية؟ @mohe_sa #رؤية_السعودية_2030https||	POS
ذهبت لتسأل مدرس طفلتها عن سبب ضربه للطفلة فضرب الأم لانها سألته هذا ليس في السعودية بل في بلد متقدم في مجال حرية المرأة فهي متساوية مع الرجل في كل شيء فلا تنخدع المرأةفي دعوات إسقاط الولاية فما نراه من تاقات وقصص مختلقة ومحاولة شيطنة الأهل ماهو الى خطوة الى الجحيم #معنفه_بريده	||POS
@KingSalman يا ملكنا اسقط نظام الولايه عن المرأه الراشده فهو من مخلفات الصحوه لا يمت للدين بصله و هو لا يتوافق مع رؤيتكم ٢٠٣٠. يعلم الله ان نظام الولايه هو نظام جائر و مجحف بحق المرأه السعوديه لماذا تعامل كقاصر من المهد الى اللحد ؟ #سعوديات_نطلب_اسقاط_الولايه600	||POS
متى تسقط الولايه كلياً عن المرأه السعوديه الراشده و تتساوى بالحقوق مع الرجل. كل شي يتعلق بالمرأه يجي بالقطاره متى تنتهي هالمعاناة متى نطوي صفحة نظام الولايه الظالم و معد نرجعلها؟ #جحيم_الولايه #سعوديات_نطلب_اسقاط_الولايه599	||POS
متى تسقط الولايه كلياً عن المرأه السعوديه الراشده و تتساوى بالحقوق مع الرجل. كل شي يتعلق بالمرأه يجي بالقطاره متى تنتهي هالمعاناة متى نطوي صفحة نظام الولايه الظالم و معد نرجعلها؟ #جحيم_الولايه #سعوديات_نطلب_اسقاط_الولايه595pic.twitter.com/vleQguxzzm	||POS
#اليوم_الاثنين اتمنى من #فخرنا_سلمان_ومحمد اسقاط الولايه كلياً عن المرأه السعوديه الراشده و مساوتها بالحقوق مع الرجل كما هم متساوون بالعقوبات و الواجبات. #تمكين_المرأه #جحيم_الولايه #سجينات_منسيات #انقذوا_فتيات_دار_الرعايه #سعوديات_نطلب_اسقاط_الولايه594	POS
#الولايه_انتهاك_لحقوق_الانسان أنا مع اسقاط الولايه عن المرأة السعودية	||POS
نسمع عن تمكين المرأه ولا شفناه، التمكين الحقيقي يكون اولاً بإسقاط الولايه كلياً عن المرأه السعوديه الراشده و اعطائها كامل حقوقها. الى متى يا وطن و النساء يطالبون بأبسط حقوقهم؟ #سعوديات_نطلب_اسقاط_الولايه580 #انا_مع_اسقاط_الولاية_على_المرأة #لماذا_السعوديات_قاصرات_للأبد||	POS
اللهم بشرنا بسقوط الولاية عن المراة السعودية #انا_مع_اسقاط_الولاية_على_المرأة #سعوديات_نطلب_اسقاط_الولايه571	||POS
#أنا_مع_إسقاط_الولاية_على_المرأة لأنه حق ولأن منظومة الظروف والأوضاع الداخلية تغيرت ولأن المرأة السعودية ترتبط بالمشهد العام .. وأمام هذا الوعي الجديد وضع الولاية بالشكل القائم يحتاج إلى مراجعة وتعديل .. بعيداً عن كل التصورات الموروثة 	POS
نسمع عن التمكين ولا شفناه، التمكين الحقيقي يكون اولا بإسقاط الولايه كلياً عن المرأه السعوديه الراشده و اعطائها كامل حقوقها. #انا_مع_اسقاط_الولاية_على_المرأة #سعوديات_نطلب_اسقاط_الولايه574 #تمكين_المرأه #على_حد_سواء	||POS
إمتلاك المرأة اهليتها ومساواتها مع الرجل حق إنساني لا يبرر . اسقطوا الولاية عن المرأة السعودية #انا_مع_اسقاط_الولاية_على_المرأة||	POS
#الشعب_السعودي_يناشد_الملك يا ملكنا اسقط نظام الولايه عن المرأه الراشده فهو من مخلفات الصحوه لا يمت للدين بصله و هو لا يتوافق مع رؤيتكم ٢٠٣٠. يعلم الله ان نظام الولايه هو نظام جائر و مجحف بحق المرأه السعوديه لماذا تعامل كقاصر من المهد الى اللحد ؟ #سعوديات_نطلب_اسقاط_الولايه549	||POS
مع #اسقاط_الولاية عن المرأة في السعودية	||POS
أخي الشاب شاهد المراة السعودية النسوية العفيفة جدا التي لن ولم يؤثر فيها قرار #اسقاط_الولايه بالسفر لانها شريفة جدا ولن تسيء إستعماله حتى البصاق عليهم لايستحقونه فضلا عن إنك تتزوج منهم #اسقاط_النفقه التغريدة مصورة تحسبا للحذف https://twitter.com/T0T__1/status/1189930685999591425?s=19 … ||NEG
نعم يجب تشديد العقوبات علي هولاء وأمثالهم.. ولكن هل تعلم أن من تضع صورته في حسابك هو من سعي علي #اسقاط_الولاية عن المرأه وهو من اسقطها بعد ذلك وهو كذلك صاحب نيوم السياحية التي لاتنطبق عليها قوانين #السعودية.؟ ||NEG
خبر إسقاط الولايه عن المرأه السعوديه.من اعلى سلطه بالبلد. وقع كالصاعقه على رأسه! وتقبله وهو راضخ وصاغر. وفي كلب نباح ثاني مثله اسمه (موجز الاخبار) وكلب نباح ثالث اسمه (محمد عبدالعزيز) واجد الكلاب النبّاحه لكن حرفياً هؤلاء الي شفتهم مندمرين نفسياً. وقريباً شهار بيستقبلهم. ||NEG
كره المرأة السعودية زاد لحد القتل تصور لو هؤلاء النسويات مو فيه واصدرت قررات مثل اسقاط الولاية والقيادة مكان صار الكره هذا الأن النسويات شغلتهم الأستفزاز قبل القرار ماتكلم عن المضحوك عليها بل عن من تعرف هي ليش تكتب ذكور وعبدة ذكور وكيذا وتستفز المجتمع بأمر من السيد ||NEG
الله يرد كيدهم بنحورهم المراه في السعوديه اميره محموله مكفوله الرجل مسؤؤل عنها في كل شي ماغير تطلب وتدلل ومطالبنا ليست إسقاط الولايه فلاغنى لنا عن ولينا ولاخلع الحجاب اللي هوستروعفاف لنا مطالبنا بسيطه والدوله تعمل جاهده لتحقيق كل مانريد من يريد اهانتنا نقول له لاتستطيع ||NEG
لو أنّ لكِ في عيادة الماضي واجعة .. لعلمتِ أنّ المرأة السعودية _خاصة في المنطقة الغربية و الجنوبية _ كانت هي المحرك الأساس لعجلة معيشة الأسرة .. فأين أولئك عن هذه التي لاتزال تبحث عن إسقاط الولاية و تستثقل حتى ( غسل المواعين ) 	||NEG
مستحيل نجد مجنس يعترف بجنسيته الاصلية بل نجدهم متسعودين مع الايمان التام بجنسيتهم الاصل بالخفاء ..ولكي تعرفهم تجد نباحهم لايتعدى شؤون المرأه السعودية وحقها بالتبرج او اسقاط الولايه او مساواتها مع الرجل.. وفي وقت اخر يتحدثون عن مظلوميتها بتوجد خبيث ..هم كالروافض في التقيا.. ||POS
يا اخي قبل فترة وماهي ببعيدة بعد اسقاط الولاية بالتحديد قامت هاشتاقات قائمة على كره الرجال في السعودية ولم نراكم تدافع عن حق جميع الرجال واذا جاء الامر في المرأة انتفضتم ||POS
العالم تتطور وفاهمين الحريه هي حرية العقل والفكر وحنا للاسف حرية جسد فقط قاعدين ننجرف ونرجع ورى والعالم قدام وين الحريه الطور اللي نشوفه كله عن المراه السعوديه إسقاط الولايه الاختلاط خلع الحجاب وين التطور والتقدم اللي نسمع فيه والحين تركب سيكل قدم العالم وين الحيا والحشمه ||	NEG
اتذكر تصريح لولي العهد قال سوف يقود السعوديين التغيير في المنطقة الان اصبح كلامه حقيقي بعد إسقاط الولايه عن المرأه السعوديه أصبحنا نسمع مطالبات المرأه القطريه والعمانية ||POS
#سعوديات_نطلب_اسقاط_الولايه1122 تسقط جميع أنظمة الولاية عن المرأة السعودية كليًا بجميع أشكالها تسقط تسقط تسقط.. ||POS
تسقط الولاية عن المرأة السعودية بشكل كامل. #اسقطوا_بلاغ_التغيب #سعوديات_نطلب_اسقاط_الولايه1122 ||POS
متى يجي اليوم اللي نرجع فيه ناس طبيعيه من غير اي تعميم " السعودين ، السعوديات ، الشعب السعودي " كل واحد يعيش بطريقته اللي عند مشكلة يتكلم عن نفسه ، كل واحد يبرر تصرفه عند طريق الشعب ، تبغى تشيل الحجاب "المرأه السعودية محرومه من حريتها " ما تبغى تسمع كلام اهلها " اسقاط الولاية " ||POS
من اعجب ما سمعت ان المرأة خارج السعودية اذا ارادت الحضور للعمرة او الحج لا تقبل السلطات في المملكة حضورها الا بولي الامر والمرأة السعودية يفتحون لها المجال لتسافر بدون محرم ولا اذن ولي #إسقاط_الولاية_عن_المرأة ||POS
٢٥ مارس إعلان عاصفة الحزم ٢٥ أبريل رؤية ٢٠٣٠ ٥يونيو قطع العلاقات بين السعودية وقطر ٣١اغسطس ميلاد ولي العهد السعودي+إسقاط الولاية عن المرأة السعودية ٢٦سبتمبر يوم إدخال المرأة السعودية في مجلس الشورى في عهد الملك عبدالله وايضا السماح بقيدتها للمركبات في عهد الملك سلمان ||POS
والله ما فيه اي مسلمه داخل السعوديه او خارجها تطلع عن كلام ولي أمرها ابوها و اخوها وكل ما يدور حولنا من الترفيه كسر لحشمة المرأة المسلمه و انا مسؤل عن كلامي من بيعها بجوار الأجانب إلى الحفلات إلى إسقاط الولايه ||NEG
أعظم أحداث شهر أغسطس : •يوم مولدي •إسقاط الولاية عن المرأة السعودية ||POS
انشهد انه رجال كفو وعارف وش يقول الله يكثر من امثاله طبعا حكومتنا رشيدة وتشتغل لصالح الشعب والناس الله يطول بعمرها بس هو قصد بكلامه الناس الي يبغون يجردون السعودية من اسمها وتاريخها عن طريق نسائها والي كل يوم والثاني اطلقو هاشتاق اسقاط الولاية عن المرأة وغايتهم معروفه ||NEG
مع إسقاط الولاية عن المرأة السعودية بدأوا يتكلمون عن المساواة وضرورة تحمل المسؤوليات بين الجنسين.. في الحقيقة هم لايؤمنون بالمساواة أصلاً هذا فقط صياح بدون صوت ||POS
طالبوا بقيادة المرأة ...صار طالبوا بأسقاط الولاية...صار اما يطالبون بتخلي عن القبيلة لا هذا اللي مايصير ومحد يطالب بهذا الشي غير السعودية المتجنسة اما السعودية الأصلية بنت القبيلة ماتطالب بهذا الشي. #سعوديات_نطلب_اسقاط_القبيله ||	NEG
صاحب السمو الملكي الأمير فيصل بن محمد بن ناصر بن عبدالعزيز ( وحديث شيق عن إسقاط الولاية) (ستندمون) #سقطت_الولاية_عن_المراة_السعودية pic.twitter.com/7x3T0QNetk 	||POS
ناصر الصرامي يكتب عن السعودية: من يقف خلف " #إسقاط_الولاية_عن_المرأة - Arabichttps://arabic.cnn.com/entertainment/2016/10/19/saudi-woman-rights-opinion … 	||POS
هذي النوعية من المرتزقة فيهم اعلى درجات البجاحة تعطي رأيها في اسقاط الولاية عن المرأة السعودية من اي منطلق من منطلق انها من اهل البلد ! تروح تناقش وضع المرأة الأردنية لو كانت صادقة النوايا ولابتفهمنا ان قلبها ع نسيج المجتمع السعودي لا وفي قناة ممولة من قطر 	||NEG
للأسف بنات السعوديه صاروا يبغون انفتاح وتأثروا بالغرب وبعض دول الخليج .. لكن خبر اسقاط الولايه غير صحيح البعض فهمه غلط ورفعوا هاشتاق تم سقوط الولايه عن المرأه وهوا غير صحيح ||	NEG
الحمدلله علئ نعمه السعوديه تخيلي هاشتاق #سعوديات_نطلب_اسقاط_الولايه1120 من 2016 ليومنا هذا ما شفنا نسويه تم اعتقالها او قمعها بل تم إسقاط الولايه والتجاوب مع مطالبهم وبقطر هالهشتاق ما كمل يومين #اسقاط_الولاية_عن_المرأة_القطرية الا ومعتقلين نصف الشعب القطري حكومة قطر قمعية ||POS
قرار اسقاط الولاية عن المرأة السعودية ، كشف لنا أنّ غالبية الذكور يحتاجون لولاية ||	POS
في شوفاتك تلقاهااااا ان شاءالله #اسقاط_الولاية_عن_المرأة_السعودية ||POS
في شوفاتك تلقهاااااا ان شاءالله .. #اسقاط_الولاية_عن_المرأة_||	POS
كثير في اشاعات عن هذا الموضوع وقبل فتره طلعت بنت وتكلمت ان كلنوا يتاجرون فيها المحزن محد يتطمن عنهم بعد ما يدخلون ابداً!!! مافي مراكز تأهيل او اي شي!! #سقطت_الولاية_عن_المراة_السعودية #سعوديات_نطلب_اسقاط_الولايه1116 ||NEG
شوفي بجاحتها كانت تدخل في حقوق النسويات بالسعوديه و قناة الجزيرة القطريه سوت فيديو كامل عن الولايه بالسعوديه ولما الحكومه السعوديه اعطت المرأة كامل حقوقها و أسقطت الولايه صارت تقف ضد بنات بلدها القطريات الي يطالبون ب اسقاط الولايه في بلدهم عرفتي مين الي كان يستغل مطالبنا !!؟ pic.twitter.com/hlSGxtdJvf 	
كيف علقت #رهف_القنون على قرار "إسقاط الولاية" عن سفر المرأة السعودية؟ https://cnn.it/2Kuxd42 ||NEG
#حقوق_المرأة_القطرية #الولايه_سقطت السعوديه دوله مؤثره ، فلا نستغرب قيام حركات حقوقيه بقوه بالدول المجاوره بعد اسقاط الولايه عن السعوديات ، قرار الاسقاط حرر المرأه السعوديه ودفعه معنويه قويه للمرأه العربيه وخصوصا الخليجيه للمطالبه بحقوقهم ||NEG
صدق من قال عن المعاريض بأنهم متسلقين ومنافقين عندما تقود المرأة السعودية وتسقط الولاية سوف يغيرون جلدهم ويقول انهم مع قيادة المرأة ومع اسقاط الولاية . قبحهم الله منافقين بلاا حدود..|| NEG
اسقاط الولاية عن المرأة السعودية كشف لنا عن الأعداء الحقيقين للمرأة السعودية وعن الأمراض النفسية التي يعانون منها. الله يحفظ الوطن من هذه النوعية من البشر .اللهم امين ||NEG
اسقطو الولاية عن المرأة السعودية بشكل كامل عن جميع جوانب حياتها لكي لا يبقى مجال واحتمال تتضرر باي شكل من الأشكال #سعوديات_نطلب_اسقاط_الولايه_كليا1119 ||POS
كل المحاولات اللي كنها نعتبرها بائسه وكنها نعتقد ان قطر هي من تروج لهالهاشتاقات والمطالب الغير مشروعه اصبحت بالعكس فهي من داخلنا ومن لحومنا للاسف اسقاط الولايه عن المرأه السعوديه اقرب مثال فالمطالب تتحقق واحدة تلو الاخرى #من_حقك_تطلعين_بدون_عبايه ||NEG
علقت صحيفة “واشنطن بوست” الأمريكية على قرار تخفيف قوانين وصاية الرجل على المرأة، مؤكدة أنها جاءت لتلميع صورة ابن سلمان وليس من أجل تحرير المرأة. و أن “السعودية هي ديكتاتورية، ويعلن ولي العهد عن قراراته حسبما يريد”. #اسقاط_الولاية ||NEG
سبحان الله مع ان عزمي بشاره رئيس قطر يظهر انهم عايشين في سلام وان السعوديه هي العدو للنساء .. ياخذ فلوس القطريات ووظائفهم ويوظف اليهود عنده واكبر دليل فاتح سفاره إسرائيليه عنده في قطر. #اسقاط_الولاية_عن_المرأة_القطرية ||POS
مبرووك للموأه السعوديه على هذا الانتصارات النساء للنساء .... #إسقاط_الولاية_عن_المرأة pic.twitter.com/496TtnGNPI ||POS
ومن قالك أن المرأة ماتسافر لحالها روحي شوفي الطيارات والقطارات وسيارات الأجرة ما حد وقف على فتوى ولا غيرها والموضوع توسع وهو كان عن السفر دون إذن ولي أمرها وبنات المنظمات يبون إسقاط الولاية وانبسطوا على الخبر من مقاصة العقل وفرحتهم انهم يبون يسقطون المرأة السعودية بزعمهم! ||POS
رغم ان المرأه السعوديه باقي لها حقوق مهمه مثل تحديد سن الرشد الا اني ادعم اسقاط الولايه عن كل النساء ||POS
رأي الشيخ صالح المغامسي في قضية إسقاط الولاية عن المرأة #الكويت_السعوديه pic.twitter.com/08qNEtGmOn ||POS
هي تقول انها السبب في اسقاط الولايه عن المراه في السعوديه لما كنسلت حفلها في السعوديه وكذا جا ذا رد عليها بالأنجليزي انه انتي بوادي وحنا ||	POS
إسقاط الولاية رسمياً عن المرأة السعودية بحق السفر https://www.alaraby.co.uk//society/2019/8/1/%D8%A5%D8%B3%D9%82%D8%A7%D8%B7-%D8%A7%D9%84%D9%88%D9%84%D8%A7%D9%8A%D8%A9-%D8%B1%D8%B3%D9%85%D9%8A%D8%A7-%D8%B9%D9%86-%D8%A7%D9%84%D9%85%D8%B1%D8%A3%D8%A9-%D8%A7%D9%84%D8%B3%D8%B9%D9%88%D8%AF%D9%8A%D8%A9-%D8%A8%D8%AD%D9%82-%D8%A7%D9%84%D8%B3%D9%81%D8%B1 … ||POS
#نيكي_ميناج تثير غضب السعوديين بسبب ردها على تغريدة تزعم أن الفضل لها في اتخاذ السلطات السعودية قرار إسقاط الوصاية عن المرأة. وكتبت: "لست متأكدة من كوني السبب في إسقاط الولاية عن المرأة في السعودية، وذلك بعد انسحابي من حفل جدة، ولكن لا يزال الطريق طويلًا، وهذا الأمر أسعدني حقًا". pic.twitter.com/yqwFWg7iG1 ||POS
#حقوق_المراه_القطريه أين "الإخوانطينيات" اللي ازعجونا بحقوق المرأة السعودية عن هذا الوسم #اسقاط_الولاية_عن_المرأة_القطرية ؟ لماذا لاينتصرن لأخواتهن القطريات ليثبتن أن ردحهن ليس تسيس وحزبية مدفوعة؟ علماً انهن مسحوقات وحقوقهن كحيائهن كلاهما منزوع! @fatimaalwahsh @EHSANFAKEEH 	||NEG
#منوعات ■| هذا الأمر أسعدني جداً... 》》{نيكي ميناج} تثير غضب السعوديين بتغريدتها .. أنا السبب في إسقاط الولاية عن المرأة #السعودية .!!pic.twitter.com/ir3TSRZION ||POS
لماذا لم نسمع أو نقرأ لإسلامي كويتي، إشادة بقرار السعودية إسقاط الولاية عن المرأة؟ هل لأن القرار يخالف ثوابتهم؟ أم لأنهم باتوا ضد أي قرار سعودي؟ أم أن هناك موضوعا آخر؟ ||POS
#اسقاط_الولاية_عن_المرأة_القطرية الهاشتاق صادم وفيه قيود لم تمر بها المرأة السعودية من الأصل لكن الله نساء قطر اقدم لكن دعمي رعم اني لا أملك الخبرة مع حكومة جاحدة انا اعرف اتعامل مع حكومة #السعودية_العظمى دولة المؤسسات التي قدمت لنا الدعم لننال كامل حقوقنا الله لا يخلينا. ||POS
#اسقاط_الولاية_عن_المرأة_القطرية هذا يعتمد على قوة المرأة القطرية لتحقيق مطالبها ويعتمد على الاعلام والمنظمات الدوليه تحيا المرأة السعودية هيا دائما في المقدمة شكرا سيد محمد بن سلمان تحيا السعودية العظمى. 	POS
والله ما ادري كيف بنات أهلك بس الحمدالله بنات السعودية من اشرف و ارقى البنات. الولاية سقطت و الامور افضل من كذا مافي. عالمات، كاتبات، صاحبات عمل ناجحات، محترفات رياضة و اللسته لا تنتهي من افضل القرارات اللي نزلت #إسقاط_الولاية_عن_المرأة ||POS
استغرب من بعض المستائين من #إسقاط_الولاية_عن_المرأة في السعودية وبلدانهم لا يوجد بها وصاية عليها ! يعني حلال على نسائكم حرية السفر والتنقل والإمرأة السعودية حرام؟ أو مثلاً نسائكم كاملين الاوصاف والسعودية ناقصة عقل ودين! إرتقوا وتحضروا.. ماوصلنا لهالتخلف غير هالقوانين. ||POS
المرآة السعودية دائماً وابداً متمسكة بدينها وغير متمردة عن الدين كل ماتطلبه حقوقها الغير مخالفة للدين ونالتها وهي قد الثقة المعطاة لها ، مجتمعي العزيز عارضت على القيادة والان أصبحت مشجع لنا عارضت على السينما والان انت اول الحضور كونو مرينين فالحياة بسيطة وجميلة #اسقاط_الولاية ||POS
هشتاقات لمتسعودات اهدافها اخراج المرأه السعوديه الاصل لشارع ليتمكن منها اللبراليين ومدعين الحريةالشخصيه. وقد تكلمنا لن يبقى الهدف على اسقاط الولايه بل ستستمر اهدافهم لما هو ابعد ولكن من يفهم اللعبه و#اسقاط_النفقه_المهر_عن_السعودي1 ||NEG
#إسقاط_الولاية_عن_المرأة مبروك للمرأة السعودية شكرًا سيدي ولي العهد قرار تاريخي ومازال البكاء والنواح مستمر ||POS
#إسقاط_الولاية_عن_المرأة شأن سعودي بحت ولكن يشرفنا نصفق و نهلل لكل خطوة تطور وتقدم تعيشها السعودية. مخطئ من يعتقد تمتع السعوديين بحريات اكثر يزعجنا نحن الكويتيين .. بالعكس نتمنى لهم الحرية التي يستحقونها. ||POS
لايسافرن إلا بإذن ولا يتزوجن من غير الأسره المالكه إلا بإذن من #الملك.. إسقاط الولاية عن المرأه في #السعودية هو حمايه لفساد المرأه وتشريع للفساد ومخالفه لشريعة #الإسلام.. وسيفتح باب الفساد والتفكك الأسري وكل شر،وهذا ماتسعي له الحكومه السعوديه. ||NEG
متى تتطورو وتصيرو زي السعودية؟!! فاكرين التطور كحول واستضافة لجرب الشمال والصهاينة!! #اسقاط_الولاية_عن_المرأة_القطرية ||POS
روحي روحي شدي حيلج في هشتاق #إسقاط_الولاية_عن_المرأة يا السعودية ||	POS
#اسقاط_الولاية_عن_المرأة_القطرية السعودية وقطر دول وهابية تدعي تطبيق الإسلام والشريعة و محبة عمر و تطبيق منهجه كانوا يستعبدون الرجال والنساء و الآن يتنافسون في تطبيق منهج إيفانكا وقد يسبقون كل الدول العربيه الأخرى ||NEG
مسؤولينا أصبحوا بين نارين : إما أن يطبقوا مافعلته السعودية للمرآه وبذلك يكونوا قد خضعوا لسياسة محمد بن سلمان و إما ان يكونوا تحت رحمة الحراك النسوي الذي بدأ يشتعل داخلياً قاتل الله الغباء #اسقاط_الولاية_عن_المرأة_القطرية ||POS
إسقاط الولاية عنك يا عاقلة حق ؛ أي لا يوجد مبرر من شكر والدك أو تزكية زوجك أو أي رجل في الكون تعبيراً عن سعادتك بالقرار . لا أعتقد أن في القرار إساءة للرجل حتى نداري خاطره و نبرر أن القرار لمن تحتاجه من المعنفات بأي شكل ، ركزوا على "بأي شكل". #سقطت_الولاية_عن_المراة_السعودية ||POS
المرأه لدينا أصيبت بدوخه .. تتسائل كيف يدعم إعلامنا الحراك النسائي في السعوديه المدعوم حكومياً أصلاً هناك ثم يتجاهل مطالب المرأه هنا داخلياً #اسقاط_الولاية_عن_المرأة_القطرية ||POS
#اسقاط_الولاية_عن_المرأة_القطرية .. الظلم في أي مكان هو خطر على العدل في كل مكان .. تجربة المرأة السعودية في الحصول على أهليتها استمرت قرابة ١١١٦ يوم من التعريف و المطالبات و إشهار القضية إعلامياً .. حتى حصلوا على الحق .. ||POS
#الولاية_سقطت #إسقاط_الولاية_عن_المرأة #السعودية #متي_ناويه_تسافرين #المرأة_السعودية pic.twitter.com/kWJ9GfisHK ||POS
أهني نفسي بمناسبة يوم ميلادي ٣ أغسطس و اللي هوا كمان #ميلاد_امير_الطرب ♡ @Abdulmajeed6531 و أبارك لنفسي و ل #السعودية_العظمى أكبر إنجاز بوجهة نظري ألا وهو ☆( #إسقاط_الولاية_عن_المرأة)☆ ||POS
طالبت منظمات حقوقية دولية بالإفراج عن الناشطات والناشطين المعتقلين بسبب نشاطهم السلمي، وذلك استكمالاً لإقرار إسقاط الولاية عن المرأة السعودية. قراءة المزيد عبر الرابط http://bit.ly/2GJTKst pic.twitter.com/msBVNT4Coy ||POS
الذكور القطريه بدال لا هم بالشين نفسهم بقرارات المرأة السعوديه خل ياكلون خراهم ويروحون يطالبون ويقفون مع حقوق البنت القطريه #اسقاط_الولاية_عن_المرأة_القطرية ||POS
بعد أن سمحت السعودية للنساء بالسفر هاشتاك متى ناوية تسافرين يتصدر تويتر #متي_ناويه_تسافرين #الغاء_تصريح_الزواج #شكرا_محمد_بن_سلمان #لا_ولاية_على_سفر_المرأة #الولاية_سقطت #السعاده_هي_باختصار #اسقاط_النفقه_المهر_عن_السعودي1 https://arabic.arabianbusiness.com/arab-world/371359-%D8%A8%D8%B9%D8%AF-%D8%A3%D9%86-%D8%B3%D9%85%D8%AD%D8%AA-%D8%A7%D9%84%D8%B3%D8%B9%D9%88%D8%AF%D9%8A%D8%A9-%D9%84%D9%84%D9%86%D8%B3%D8%A7%D8%A1-%D8%A8%D8%A7%D9%84%D8%B3%D9%81%D8%B1-%D9%87%D8%A7%D8%B4%D8%AA%D8%A7%D9%83-%D9%85%D8%AA%D9%89-%D9%86%D8%A7%D9%88%D9%8A%D8%A9-%D8%AA%D8%B3%D8%A7%D9%81%D8%B1%D9%8A%D9%86-%D9%8A%D8%AA%D8%B5%D8%AF%D8%B1-%D8%AA%D9%88%D9%8A%D8%AA%D8%B1 … ||POS
لتعرف حجم المصاب وحجم الشهيد ابو اليمامه وحجم الحدث. بعد الحادث بساعات فقط اعلنت السعوديه اسقاط الولايه عن المراة وذلك كي لايكون الخبر صاعق للبعض وكذلك عشان الاعلام مشغول باللي حدث في عدن وبالتالي قرارات المملكة دايم تاتي في اوقات يكون الراي العام الاقليمي والمحلي مشغول بحدث اخر ||NEG
#اسقاط_النفقه_المهر_عن_السعودي1 نعم لا نفقه في غياب الولايه اذا سقطت هذه حتماً سوف تسقط هذه #سقطت_الولاية_عن_المراة_السعودية ||POS
#سقطت_الولاية_عن_المراة_السعودية #اسقاط_النفقه_المهر_عن_السعودي1 #عشر_ذي_الحجة اللهم من اشغل مجتمعنا وأراد به سوء فأ شغلة بنفسة ورد كيدة في نحرة اللهم اكفناهم بما شئت ||POS
حتى مع إسقاط الولاية عن سفر المرأة ستظل محا تقدر تخرج من بيتها وقت ما تبغى و تركب الطيارة و ترجع وقت ما تبغا .. لن تتحرر المرأة السعودية حتى تتحرر اجتماعيا ،، و لسا أمامها شوط طويل لذلك ||POS
#اسقاط_النفقه_المهر_عن_السعودي1 "نطالب باسقاط المهر أصبحت المراة السعودية مثل الغربية واذا عالشرع إسقاط الولاية ليس من الشرع " pic.twitter.com/X4JDWCEf0z 	
اسقاط الولاية عن المرأة السعودية هو الخبر الذي بلغت الجزيرة بسببه درجة من الحنق جعلتها تمتنع عن بثه #اسقاط_الولاية_عن_المرأة_القطرية #اسقاط_الولاية @AJArabic ||POS
#نيكي_ميناج تنسب لنفسها الفضل في إسقاط الولاية عن المرأة السعودية التفاصيل : https://bit.ly/2YHfbQW pic.twitter.com/h1l8CrrVge 	||POS
#سقطت_الولاية_عن_المراة_السعودية #اسقاط_النفقه_المهر_عن_السعودي1 وقانا الله شر السقوط..!! وسائل التواصل دكاكين مفتوحة للدنيا..فلاتنشروا فيها إلا مايليق باسم بلدكم..!!|| 	NEG
#اسقاط_النفقه_المهر_عن_السعودي1 #سقطت_الولاية_عن_المراة_السعودية يعني مالها والي!؟ من يصدر القرارت هل هم اهل الشورى ..ووفق الكتاب والسنة ام تبعية وارضى للغرب ..ورضوخ للمنظمات الحقوقية حكم سفر المرأة ..بلا محرم لايجوز ..فكيف يقر النظام بعدم منع ذلك ..اذا القرار ليس وفق الحلال pic.twitter.com/grb69xaSvz 	||NEG
#نيكي_ميناج غردت في تويتر تقول "لست متأكدة من كوني السبب في #إسقاط_الولاية عن المرأة في السعودية، وذلك بعد انسحابي من حفل جدة، ولكن لا يزال الطريق طويلاً، وهذا الأمر أسعدني حقًا". وإلى الله المشتكى والله المستعان pic.twitter.com/xt89bSE173 ||POS
هذا الحوار أُجري معي في ديسمبر عام 2015م إسقاط الولاية رسمياً عن المرأة السعودية بحق السفر سهيلة زين العابدين حماد: المواطَنة الكاملة للسعوديات http://dr-suhaila-z-hammad.blogspot.com/2019/08/blog-post_3.html … ||POS
بالفيديو: “إسقاط الولاية” عن السفر.. كيف تفوقت #السعودية على #إيران؟ https://cnn.it/2KebwWT #المرأة_السعودية ||POS
بداية اسقاط الولاية عن المرأة وهي حلقة من سلسلة الشرع المحمدي وقد بدأنا بفرط حلقاتها واحدة تلو الاخر الله يلهمهم الصواب يردهم اليه ردا جميلا ..سكان السعودية مواطنين ومقييمين معلقون في رقبة ولي الامر https://twitter.com/Basilah_Homoud/status/1157005848519909376 … ||NEG
مو مصدقة الي اشوفه بتويتر .. بعض الحسابات النسوية تحاول توهمنا بان الولاية سقطت بشكل كامل عن المراة السعودية ، اتوقع يا انهم جهلة مايفهمون شيء او هدفهم هو اسكات المطالبات عموما مازلنا نطالب بباقي حقوقنا ولن نستسلم #سعوديات_نطلب_اسقاط_الولايه1115 ||NEG
بالرغم اني مبسوطة بقرار إسقاط الولايه وتحرر المرأة السعودية من العبوديه في عصر محمد بن سلمان الله يحفظه وانو بعد شوي مقلعه إلا انو احزني موضوع وكالة SM وتلميحاتهم عن تفكك اكسوال ذا الشي نكد علي حرفيا pic.twitter.com/axfew2jcc6 ||POS
مبروك اسقاط الولاية عن المرأة السعودية مبروك للجين و لكل المدافعين و المدافعات عن حقوق المرأة ف السعودية. ||POS
#سقطت_الولاية_عن_المراة_السعودية شباب لازم نبدا حمله اسقاط المهور ونخلي الوضع فقط خاتم (: ||POS
الإعلامية #إيمان_الحمود تثني على إسقاط الولاية عن سفر المرأة السعودية وتشيد بالأمير #محمد_بن_سلمان وقيادتهhttps://cnn.it/2SZ5kom ||POS
صورة متداولة في السعودية بعد إسقاط الولاية عن المرأة في السفر pic.twitter.com/1rlnA0uiz0 ||POS
غداء #اسقاط_الولايه #سقطت_الولاية_عن_المراة_السعودية pic.twitter.com/uaRqWptaPI ||NEG
#شعور ياااا حلو البرد بعد طول اللهيب #سقطت_الولاية_عن_المراة_السعودية #سعوديات_نطلب_اسقاط_الولايه1114 ||POS
سقوط الولاية لن يُسقط التقوى والحشمة والعفة في قلوب بناتنا كما يظن البعض،وستظلّ المرأة السعودية-كعادتها-تضرب أروع الأمثلة في العلم والأدب والبذل والعطاء أمّاً وزوجةً وأختاً وبنتاً،فقط ستسقط "الأقنعة" #سقطت_الولاية #سقطت_الولاية_عن_المراة_السعودية #سعوديات_نطلب_اسقاط_الولايه1114 ||POS
المرأة السعودية تهرب من أهلها وتتخلى عن دينها قبل #اسقاط_الولاية فما الذي ستفعله اليوم بعد هذا القانون؟ ثم متى وقفت مع العراق ضد داعش ورفضت التكفير والطائفية ؟؟ عندما أتذكر حواراتي معهن في هذه الفترة وحقدهم على العراق وتشفيهم بقتل الشيعة استغرب من هذا الكلام ..! ||NEG
ليبراليه!!!! صدق إنكم عار كل حقبه زمنيه نمر فيها، ابتداءاً بتعليم البنات الى إسقاط الولايه عن المرأة البالغه.. هذي حقوق مدنيه لكل مواطن ومواطنه يعيشون على ارض المملكة العربيه السعودية 	
أرى أبي العالم كله وأراه الحكمة وأراه كتاباً يعلمني وأراه حُباً مُستوطناً قلبي .. .. أبي يريدون إسقاط ولايتهم وأنت ولايتك لي عز وفخر يا جنتي وقلبي وعمري وروحي .. #سقطت_الولاية_عن_المراة_السعودية أنتم بس سقطت عليكم وإلا ولايتي قائمة بتاج رأسي (أبي) جعل رأسي ما يميل .. 	
#سعوديات_نطلب_اسقاط_الولايه1114 #سقطت_الولاية_عن_المراة_السعودية #سقطت_الولاية https://twitter.com/HerPerfume1/status/1157140674560458753 … ||POS
قررت السلطات في المملكة العربية السعودية، اليوم الخميس، السماح للنساء باستخراج جوازات سفر دون أذن أولياء أمورهن، ما يعني فعليا إسقاط أحد أهم بنود الولاية على المرأة. وإسقاط الولاية عن المرأة مطلب نادت به نساء سعوديات، وجذب متعاطفين من كافة أطياف المجتمع ||POS
#لا_ولايه_علي_سفر_المراه لامانع في اسقاط ولاية السفر والديل من السنة عن عائشة قالت (فلما اقدمت على سفر الى الحيرة طلبت من رسول الله صلى الله عليه وسلم أن يدخل أبشر ويسمح بسفري فقال : لا ولاية على المرأة في السعودية و الولاية بس في الزواج أحيانا)رواه مسلم باب السفر بدون تصريح سفر ||NEG
هههههههههههههه بس تذكرت تهديد ذا @mishal_alzahed لريما بنت بندر يوم يقولها ابعدي عن موضوع إسقاط الولاية #لا_ولاية_على_سفر_المرأة #سقطت_الولاية_عن_المراة_السعودية ||POS
تكلمي عن نفسك..بداية مطالبة الاسقاط من العنف والاضطهاد اللي تعرضت له المرأه السعوديه تزييف الحقائق مايغير الواقع عزيزتي..اسقاط الولايه نعم حق لكن احد اسباب مطالبتنا فيه كان العنف اللي تتعرض له نساء السعوديه من ذكورها وغير انساني كون شخص كامل الاهليه يعامل كقاصر!اطلعي من كهفك. ||NEG
#سعوديات_نطلب_اسقاط_الولايه1114 #سقطت_الولاية_عن_المراة_السعودية https://twitter.com/Saudiimmigrants/status/1157052068131004417 … ||POS
إسقاط الولاية رسمياً عن المرأة السعودية في السفر https://bit.ly/2Ozxvfc pic.twitter.com/9mWNWN7OGp ||POS
